NO ./textures/north.xpm
SO ./textures/south.xpm
WE ./textures/west.xpm
EA ./textures/east.xpm

F 220,100,0
C 225,30,0\
111111111
1000S1001
100000001
111000111
111111111